2 2 2 2 2 2 2 6 2 2 2 2 2 2 2 2
2 1 1 1 1 1 1 1 1 1 1 1 1 1 1 2
2 1 1 1 1 1 1 1 1 1 1 1 1 1 1 2
2 1 1 1 5 5 5 5 5 5 5 5 5 1 1 2
2 1 1 1 5 3 3 3 3 4 4 4 5 1 1 2
2 1 1 1 5 3 3 3 3 4 4 4 5 1 1 2
2 1 1 1 5 3 3 3 3 4 4 4 5 1 1 2
2 1 1 1 5 5 5 5 5 5 5 5 5 1 1 2
2 1 1 1 1 1 1 1 1 1 1 1 1 1 1 2
2 1 1 1 1 1 1 1 1 1 1 1 1 1 1 2
2 1 1 1 1 1 1 1 1 1 1 1 1 1 1 2
2 2 2 2 2 2 2 7 2 2 2 2 2 2 2 2